x x x x x x x C x
x . . . . . . _ x
x . . . . . . _ x
x . . . _ _ _ _ x
x . . . _ . . . x
x . . . _ . . . x
x x x x _ x x x x
        D        
