x x x x x x C x x
x . . . . . _ . x
x . . . . . _ . x
x . o _ _ _ _ . x
x . . _ o . o . x
x . . _ _ . . . x
x x x x _ x x x x
        D        
