      C      
x x x _ x x x
x     x     x
x     x     x
x x x x x x x   
    x   x    
    x   x    
x x x x x x x
x     x     x
x     x     x
x x x _ x x x
      D
