  x 
x . x x x x x x x x x
x . _ . . . . _ . . x
x . _ . . . . C . . x
x . _ . . . . . . . x
x . _ . . . . . . . x
x . _ . . . . . . . x
x x _ x x x x x x x x
    D
