x x x x x x x x x
x . . . . . . . x
x . _ _ _ _ _ x  
x . _ . . . . x
x x _ x x . . x
x   D   x . . x
x       x . . x
x x x x x . . x
x . . . . . . _ x x x x
x . . . . . . _ _ _ _ C
x . . . . . . . x x x x
x . . . . . . x
x x x x x x x x
