x x x x x x x x x x
x # # # # # # # # x
x # # # # # # # # x 
x # # # C # # # # x
x # # # _ _ _ _ _ _ D
x # # # # # # # # x
x x x x x x x x x x
