:B 3 3 
x x x x x x x x x x
x # # # # # # # # x
C # # # . . # # # x 
_ # # # . . # # # x
_ # # # # # # # # _ D
_ # # # # # # # # _
_ _ _ _ _ _ _ _ _ _
