        C
        x
        x
x x x x _ x x x x x 
x _ _ _ _ _ _ _ _ x
x _ . . . . . . _ x
x _ . . . . . . _ x
x _ _ _ _ . . . _ x
x x x x _ . . . _ x
        D _ _ _ _ x 
          x x x x x
