:B 13 8 
x x x x x x x x x x x x x x x
x . . . . x x x x x . . . . x
x . . . x           x . . . x
x . . x   x x x x x   x . . x
x . x   x . . . . . x   x . x
x x   x . . . . . . . x   x x
x x   x . . . . . . . x   x x
x x   x . . . C . . . x   x x
x x   x . . . _ . . . x   x x
x x   x . . . _ . . . x   x x
x . x   x . . _ . . x   x . x
x . . x   x x _ x x   x . . x
x . . . x     x     x . . . x
x . . . . x x _ x x . . . . x
x . . . . . . _ . . . . . . x
x x x x x x x _ x x x x x x x
              D
