x x x x x x x x x x 
x . . . . . . . . x
x . _ _ _ _ _ _ _ _ D
x . _ . . . . _ . x
x . _ . C . . _ . x
x . _ . _ . . _ . x
x . _ _ _ _ _ _ . x
x . . . . . . . . x 
x x x x x x x x x x
