:B 0 0
x x x x x x x x x
      x . . . . x
      x . . . . x
      C _ _ _ _ _ D
      x . . . . x
      x . . . . x
      x x x x x x 
