:B 0 0
x x x
x . x
x . x
x . x
x C x
x _ x
x _ x
x _ x
x _ x
x _ x
  D
