:B 2 0
x x x
x
x   x x x x x x x x x
x   x _ _ _ _ _ _ _ x
x   x _ . . . . . _ x
x x x _ . . . . . _ x
    x _ . . . . . _ x
    x _ . . . . . _ x
    x _ x x x x x _ x
      D           C
