:B 12 6
  x x x x x x x x x x x C x
  x _ _ _ _ _ _ _ _ _ _ _ C
D _ _ o x x x o . o x o _ x
  x _ x       x . x   x _ x
  x _ o x x x o . o x o _ x
  x _ _ _ _ _ _ _ _ _ _ _ x
  x x x x x x x x x x x x x
