:B 8 6
  x x x x x x x x x
  x _ _ _ _ _ _ _ C
  x _ o x x x o _ x
D _ _ x       x _ x
  x _ x       x _ x 
  x _ o x x x o _ x
  x _ _ _ _ _ _ _ x
  x x x x x x x x x
