:B 13 8 
x x x x x x x x x x x x x x x
x . . . . x x x x x . . . . x
x . . . x           x . . . x
x . . x   x x x x x   x . . x
x . x   x . . . . . x   x . x
x x   x . . . . . . . x   x x
x x   x . . . . . . . x   x x
x x   x . . . C . . . x   x x
x x   x . . . _ . . . x   x x
o x   x . . . _ . . . x   x x
x o x   x . . _ . . x   x . x
x . o x   x x _ x x   x . . x
x . . o x     x     x . . . x
x . . . o x x _ x x . . . . x
x . . . . o . _ . . . . . . x
x x x x o x x _ x x x x x x x
              D
