:B 4 3 
x x x x x x x x x x x
x # # # # # # # # # x
x C # # # . . # # # x 
x _ # # # . . # # # x
x _ # # # # # # # # _ D
x _ # # # # # # # # x
x _ _ _ _ _ _ _ _ _ x
x x x x x x x x x x x
