:B 9 0 
x x x x x x x x x x
x . . x   x . . . x
x . . x   _ _ . . x 
x . . x   D _ . . x
x . . x     _ . . x 
x . . x x x _ . . x
x x x x x C _ x x x
