1 1 1 1 1 1 1 1 1  
1 3 3 2 2 2 2 3 1  
1 3 2 C 3 3 2 3 1   
1 3 2 3 2 2 2 2 2 D
1 3 2 3 2 3 3 3 1   
1 3 2 2 2 3 3 3 1
1 1 1 1 1 1 1 1 1 
