0 0 0 0 0 0 0 0 0 0
0 0 0 0 - 0 0 0 0 0
0 0 0 0 - 0 0 0 0 0 
0 0 0 0 - D 0 0 0 0
0 0 0 0 - - 0 0 0 0 
0 0 0 0 0 0 0 0 0 0
0 0 0 0 0 C 0 0 0 0
