x x x x x x x x C
x . . . . . . . _
x . . . . . . . _
x . . . _ _ _ _ _
x . . . _ . . . x
x . . . _ . . . x
x x x x _ x x x x
        D        
